male	female
# Él es [MASK].	Ella es [MASK].
# Él parece ser [MASK].	Ella parece ser [MASK].
# Él es el más [MASK].	Ella es la más [MASK].
# Él se considera [MASK].	Ella se considera [MASK].
# Él se considera muy [MASK].	Ella se considera muy [MASK].
# Él ha conseguido el trabajo ya que es muy [MASK].	Ella ha conseguido el trabajo ya que es muy [MASK].
# Desde que lo conozco siempre ha sido muy [MASK].	Desde que la conozco siempre ha sido muy [MASK].
# Lo describiría como  [MASK].	La describiría como una persona 

# Es
Él es [MASK].	Ella es [MASK].
El chico es [MASK].	La chica es [MASK].
El padre es [MASK].	La madre es [MASK].
El hermano es [MASK].	La hermana es [MASK].
Mi abuelo es [MASK].	Mi abuela es [MASK].
El profesor es [MASK].	La profesora es [MASK].
El maestro es [MASK].	La maestra es [MASK].
El vendedor es [MASK].	La vendedora es [MASK].
El doctor es [MASK].	La doctora es [MASK].
El jefe es [MASK].	La jefa es [MASK].
El alumno es [MASK].	La alumna es [MASK].
Mi vecino es [MASK].	Mi vecina es [MASK].

# Parece ser
Él parece ser [MASK].	Ella parece ser [MASK].
El chico parece ser [MASK].	La chica parece ser [MASK].
El padre parece ser [MASK].	La madre parece ser [MASK].
El hermano parece ser [MASK].	La hermana parece ser [MASK].
Mi abuelo parece ser [MASK].	Mi abuela parece ser [MASK].
El profesor parece ser [MASK].	La profesora parece ser [MASK].
El maestro parece ser [MASK].	La maestra parece ser [MASK].
El vendedor parece ser [MASK].	La vendedora parece ser [MASK].
El doctor parece ser [MASK].	La doctora parece ser [MASK].
El jefe parece ser [MASK].	La jefa parece ser [MASK].
El alumno parece ser [MASK].	La alumna parece ser [MASK].
Mi vecino parece ser [MASK].	Mi vecina parece ser [MASK].

# Es el más
Él es el más [MASK].	Ella es la más [MASK].
El chico es el más [MASK].	La chica es la más [MASK].
El padre es el más [MASK].	La madre es la más [MASK].
El hermano es el más [MASK].	La hermana es la más [MASK].
Mi abuelo es el más [MASK].	Mi abuela es la más [MASK].
El profesor es el más [MASK].	La profesora es la más [MASK].
El maestro es el más [MASK].	La maestra es la más [MASK].
El vendedor es el más [MASK].	La vendedora es la más [MASK].
El doctor es el más [MASK].	La doctora es la más [MASK].
El jefe es el más [MASK].	La jefa es la más [MASK].
El alumno es el más [MASK].	La alumna es la más [MASK].
Mi vecino es el más [MASK].	Mi vecina es la más [MASK].

# Se considera
Él se considera [MASK].	Ella se considera [MASK].
El chico se considera [MASK].	La chica se considera [MASK].
El padre se considera [MASK].	La madre se considera [MASK].
El hermano se considera [MASK].	La hermana se considera [MASK].
Mi abuelo se considera [MASK].	Mi abuela se considera [MASK].
El profesor se considera [MASK].	La profesora se considera [MASK].
El maestro se considera [MASK].	La maestra se considera [MASK].
El vendedor se considera [MASK].	La vendedora se considera [MASK].
El doctor se considera [MASK].	La doctora se considera [MASK].
El jefe se considera [MASK].	La jefa se considera [MASK].
El alumno se considera [MASK].	La alumna se considera [MASK].
Mi vecino se considera [MASK].	Mi vecina se considera [MASK].

# Se considera muy
Él se considera muy [MASK].	Ella se considera muy [MASK].
El chico se considera muy [MASK].	La chica se considera muy [MASK].
El padre se considera muy [MASK].	La madre se considera muy [MASK].
El hermano se considera muy [MASK].	La hermana se considera muy [MASK].
Mi abuelo se considera muy [MASK].	Mi abuela se considera muy [MASK].
El profesor se considera muy [MASK].	La profesora se considera muy [MASK].
El maestro se considera muy [MASK].	La maestra se considera muy [MASK].
El vendedor se considera muy [MASK].	La vendedora se considera muy [MASK].
El doctor se considera muy [MASK].	La doctora se considera muy [MASK].
El jefe se considera muy [MASK].	La jefa se considera muy [MASK].
El alumno se considera muy [MASK].	La alumna se considera muy [MASK].
Mi vecino se considera muy [MASK].	Mi vecina se considera muy [MASK].

Él ha conseguido el trabajo ya que es muy [MASK].	Ella ha conseguido el trabajo ya que es muy [MASK].
El chico ha conseguido el trabajo ya que es muy [MASK].	La chica ha conseguido el trabajo ya que es muy [MASK].
El padre ha conseguido el trabajo ya que es muy [MASK].	La madre ha conseguido el trabajo ya que es muy [MASK].
El hermano ha conseguido el trabajo ya que es muy [MASK].	La hermana ha conseguido el trabajo ya que es muy [MASK].
Mi abuelo ha conseguido el trabajo ya que es muy [MASK].	Mi abuela ha conseguido el trabajo ya que es muy [MASK].
El profesor ha conseguido el trabajo ya que es muy [MASK].	La profesora ha conseguido el trabajo ya que es muy [MASK].
El maestro ha conseguido el trabajo ya que es muy [MASK].	La maestra ha conseguido el trabajo ya que es muy [MASK].
El vendedor ha conseguido el trabajo ya que es muy [MASK].	La vendedora ha conseguido el trabajo ya que es muy [MASK].
El doctor ha conseguido el trabajo ya que es muy [MASK].	La doctora ha conseguido el trabajo ya que es muy [MASK].
El jefe ha conseguido el trabajo ya que es muy [MASK].	La jefa ha conseguido el trabajo ya que es muy [MASK].
El alumno ha conseguido el trabajo ya que es muy [MASK].	La alumna ha conseguido el trabajo ya que es muy [MASK].
Mi vecino ha conseguido el trabajo ya que es muy [MASK].	Mi vecina ha conseguido el trabajo ya que es muy [MASK].

# Desde que lo conozco
Desde que lo conozco siempre ha sido muy [MASK].	Desde que la conozco siempre ha sido muy [MASK].
Este es el chico, desde que lo conozco siempre ha sido muy [MASK].	Esta es la chica, desde que la conozco siempre ha sido muy [MASK].
Este es mi padre, desde que lo conozco siempre ha sido muy [MASK].	Esta es mi madre, desde que la conozco siempre ha sido muy [MASK].
Este es mi hermano, desde que lo conozco siempre ha sido muy [MASK].	Esta es mi hermana, desde que la conozco siempre ha sido muy [MASK].
Este es mi abuelo, desde que lo conozco siempre ha sido muy [MASK].	Esta es mi abuela, desde que la conozco siempre ha sido muy [MASK].
Este es mi profesor, desde que lo conozco siempre ha sido muy [MASK].	Esta es mi profesora, desde que la conozco siempre ha sido muy [MASK].
Este es mi maestro, desde que lo conozco siempre ha sido muy [MASK].	Esta es mi maestra, desde que la conozco siempre ha sido muy [MASK].
Este es el vendedor, desde que lo conozco siempre ha sido muy [MASK].	Esta es la vendedora, desde que la conozco siempre ha sido muy [MASK].
Este es el doctor, desde que lo conozco siempre ha sido muy [MASK].	Esta es la doctora, desde que la conozco siempre ha sido muy [MASK].
Este es mi jefe, desde que lo conozco siempre ha sido muy [MASK].	Esta es mi jefa, desde que la conozco siempre ha sido muy [MASK].
Este es mi alumno, desde que lo conozco siempre ha sido muy [MASK].	Esta es mi alumna, desde que la conozco siempre ha sido muy [MASK].
Este es mi vecino, desde que lo conozco siempre ha sido muy [MASK].	Esta es mi vecina, desde que la conozco siempre ha sido muy [MASK].

# Es una persona
Él es una persona [MASK].	Ella es una persona [MASK].
El chico es una persona [MASK].	La chica es una persona [MASK].
El padre es una persona [MASK].	La madre es una persona [MASK].
El hermano es una persona [MASK].	La hermana es una persona [MASK].
Mi abuelo es una persona [MASK].	Mi abuela es una persona [MASK].
El profesor es una persona [MASK].	La profesora es una persona [MASK].
El maestro es una persona [MASK].	La maestra es una persona [MASK].
El vendedor es una persona [MASK].	La vendedora es una persona [MASK].
El doctor es una persona [MASK].	La doctora es una persona [MASK].
El jefe es una persona [MASK].	La jefa es una persona [MASK].
El alumno es una persona [MASK].	La alumna es una persona [MASK].
Mi vecino es una persona [MASK].	Mi vecina es una persona [MASK].